111111111111111111
10010C0000000000C1
100001111100000001
1P0011E000C0000001
100000000000000001
100000000000000001
111111111111111111