11111111111111111
10000000000000001
10000000000000001
100000P000000C001
10000000000E00001
11111111111111111